{
    "cmd": "STOP_LIVE_ROOM_LIST",
    "data": {
        "room_id_list": [
            24465859,
            9786213,
            24666906,
            24786908,
            25774785,
            23860229,
            4743939,
            8080362,
            954600,
            25787715,
            70894,
            25787580,
            25787698,
            981545,
            12945730,
            14988810,
            6937991,
            9267834,
            13366864,
            23972191,
            249042,
            25749027,
            22501595,
            23640797,
            12197392,
            24230140,
            24571738,
            25770992,
            4458335,
            14184534,
            21723798,
            23540788,
            25292758,
            25665543,
            23179656,
            9411689,
            11574829,
            8215646,
            24500029,
            24578338,
            25756310,
            9597231,
            2444013,
            4457755,
            6021686,
            25748063,
            25777192,
            25784921,
            25786834,
            22438748,
            23696867,
            24226271,
            24388578,
            25778039,
            10082566,
            8925557,
            22046754,
            23409491,
            25276252,
            25645380,
            25787496,
            11684270,
            765896,
            1550666,
            25055659,
            25290277,
            2556487,
            9767307,
            24955042,
            3729685,
            4143742,
            23972463,
            25691862,
            8002119,
            1395264,
            23178488,
            25771813,
            21536777,
            22877170,
            25755356,
            12174591,
            24853506
        ]
    }
}